20 20
B...................
..#..#.......#......
..#..#.......#......
..#..#..S....#......
......####..........
......#..#..........
......#..#..D.......
..####.#..#.........
......#..#..........
......####..........
..............#.....
..D...........#.....
..............#.....
..#..#....S....#....
..#..#.........#....
......######........
......#.............
......#.....D.......
......#.............
............S.......